000000000000222222220000220000000022222200000000000000000000000000000000000000000000000000000000000000000000000000000000
000000000000001110000000000002222211111122220000000000000000000000000000000000000000000000000000000000000000000000000000
000220000000000000000000000000111111111110000000000000000000000000000000000000000000000000000000000000000000000000000000
000000002200000000000000000000000011110000000000000000000000000000000000000000000000000000000000000000000000000000000000
000000021122000000000000000000000001000000000000000000000000000000000000000000000000000000000000000000000000000000000000
000000000110000220000000000000000000000000000000000000000000000000000000000000000000000000000000000000000000000000000000
220000000000002112200000022000000000000000000000000000000000000000000000000000000000000000000000000000000000000000000000
112222222222221111100002211200000002222200000000000000000000000000000000000000000000000000000000000000000000000000000000
111111111111111111000001111100000021111122200000000000000000000000000000000000000000000000000000000000000000000000000000
110000000000011111000000110000000000011111000002200000000000000000000000000000000000000000000000000000000000000000000000
112200000002211111000000000000000000000000000021122000000000000000000000000000000000000000000000000000000000000000000000
011122220000000000000000000002222200000000000001110000000000000000000000000000000000000000000000000000000000000000000000
000000000000000000000000022221111122222222000000100000000000000000000000000000000000000000000000000000000000000000000000
000000222222222222222222211111111111111100000000100000000000000000000000000000000000000000000000000000000000000000000000
000000001111111111111111111111100000000000000000000000000000000000000000000000000000000000000000000000000000000000000000
000000000000000000000000000000000000000000000000000000000000000000000000000000000000000000000000000000000000000000000000
000000000000000000000000000000000000000000000000000000000000000000000000000000000000000000000000000000000000000000000000
000000000000000000000000000000000000000000000000000000000000000000000000000000000000000000000000000000000000000000000000
000000000000000000000000000000000000000000000000000000000000000000000000000000000000000000000000000000000000000000000000